0x00000000 0x08001000 0x00000000 0
0xC1000000 0xC1000020 0x00000000 1
0xC3000000 0xC3000100 0x00000000 2
0xC4000000 0xC4000200 0x00000000 3
0xC5000000 0xC5100000 0x00000000 4
0xC6000000 0xC6100000 0x00000000 5
0xC7000000 0xC7000010 0x00000000 6
0xC2000000 0xC2000010 0x00000000 7
0xC2000010 0xC2000020 0x00000000 8
0xC2000020 0xC2000030 0x00000000 9
0xC2000030 0xC2000040 0x00000000 10


